abandon	vt.	抛弃；放弃；放纵；沉溺
abandoned	adj.	被抛弃的，废置的
abandonment	n.	抛弃；放弃
abbreviate	vt.	缩短；缩写
abbreviation	n.	缩写；缩写词
abide	vi.	遵守，忍受
abiding	adj.	持久的
ability	n.	能力，才干
inability	n.	无能，无力
capability	n.	能力，性能，容量
viability	n.	生存能力；可行性
variability	n.	可变性
ablaze	adj.	着火的，燃烧的；闪耀的
blazing	adj.	炽烧的，闪耀的
abnormal	adj.	反常的，异常的；变态的
normal	adj.	正常的，正规的，标准的
abolish	vt.	废除，取消
abolition	n.	废除，取消
abolitionist	n.	废奴主义者
abort	n.	中止计划（任务）
abound	vi.	充满；富于
abrasion	n.	磨（擦）破；表面磨损
abrasive	adj.	研磨的
abrupt	adj.	突然的，意外的
absenteeism	n.	旷课；旷工
absentee	n.	缺席者
absent	adj.	缺少的；不在的，缺席的
absence	n.	缺少；不在，缺席
absolute	adj.	完全的；绝对的
absolutely	adv.	完全地；绝对地
absorb	vt.	吸收（液体、知识）
absorption	n.	吸收
abstract	adj.	抽象的；摘要，提炼
absurd	adj.	荒谬的，可笑的
abundant	adj.	丰富的，充裕的；大量的
abundantly	adv.	丰富地
abundance	n.	丰富，充裕
abuse	vt.	滥用；虐待
abut	vi.	邻接，毗邻
academic	adj.	学术的；学院的；理论的
academician	n.	学会会员；院士；学者
accelerate	v.	加快，加速
accelerated	adj.	加速的，迅速的
accelerating	adj.	加速的
acceleration	n.	加速度
access	n.	接触，接近（的机会，入口，通道
accessible	adj.	可接近的，可接触的；可得到的
accessibility	n.	易接近；可达到
accessory	n.	附件，零件
accidental	adj.	意外的，偶然的
accidentally	adv.	意外地，偶然地
accident	n.	意外事件，事故
acclaim	n.	赞誉，赞许，喝彩，欢呼；称赞
acclaimed	adj.	受人欢迎的
accommodate	vt.	为提供食宿；与相符，与相适应
accommodating	adj.	乐于助人的
accompany	vt.	陪伴，伴随；伴奏
accompanying	adj.	陪伴的，伴随的
accompaniment	n.	伴奏
accomplish	vt.	完成，达到，实现
accomplished	adj.	精通的，熟练的
accomplishment	n.	成就
accordion	n.	手风琴
account	n.	说明，解释，户头，账户，解释
accounting	n.	会计学
accountant	n.	会计员，会计师
accredit	vt.	授权
accumulate	vi.	堆积，积聚；积累
accumulation	n.	积聚
accurate	adj.	准确的，正确的
accuracy	n.	准确性，正确性
accuse	vt.	指责，归咎
accusation	n.	谴责；控告
accustomed	adj.	习惯了的
achieve	vt.	完成，实现
achievement	n.	成就，功绩
acid	n.	酸，酸的，尖酸的，刻薄的
acidic	adj.	酸的，酸性的
acidity	n.	酸度，酸性
acquaintance	n.	熟人
acquaint	v.	熟悉
acquisition	n.	获得
acquire	vt.	获得，学到
acronym	n.	首字母缩写词
actual	adj.	实际的，现行的
actually	adv.	实际上，事实上
actuate	vt.	开动，促使
activate	vt.	刺激，使活动
actively	adv.	活跃地，积极地
acute	adj.	灵敏的，敏锐的；剧烈的；很严重的
acumen	n.	敏锐，聪明
adapt	v.	（使）适应，调整；改编
adaptable	adj.	能适应的，适应能力强的
adaptation	n.	改编，改写；适应环境
adaptive	adj.	适合的；适应的
addict	vt.	使上瘾，使沉溺；上瘾的人
addictive	adj.	（使人）上瘾的

